R 500 500
NO ./textures/bricks.xpm
SO ./textures/stone.xpm
WE ./textures/purple.xpm
EA ./textures/moss.xpm

S ./textures/AnyConv.com__mushroom.xpm
F 200,200,200
C 255,255,255

1
11
101
1001
10001
100001
1020001
10000001
10N000001
111111111
